akn: auto pk người di chuyển được
akn1: auto pk người tự tele vào nhân vật pk
hlct: bật tắt auto dùng hlct
pka: tự đi pk âm ngay
uppk: mở menu pk âm
ak: bật tắt tự đánh
buff: auto hồi sinh + buff
hsx: auto hồi sinh
bux: buff xa
anv: auto nhiệm vụ hằng ngày
cy: xem yên up
clv: xem lv up
locdo: bật tắt lọc đồ
hsl: bật tắt hsl
ause + id vật phẩm: tự dùng vật phẩm trong hành trang
spuse + : cài tốc độ sử dụng item
c: fake tầm cao
n: fake tầm ngang
rss: reset fake tầm cao, ngang
addn: thêm nhân vật vào nhóm
cn: xoá nhóm
dspt: mở danh sách mời nhân vật vào nhóm
die: tự sát
dspk: mở danh sách pk
dshs: mở danh sách hồi sinh
dsn:
dsd:
cnhat: nhặt xa | hút xa
x: khoảng cách nhặt
kcts: khoảng cách tàn sát
avt: thêm vị trí up map hiện tại
dvt: xoá vị trí up map hiện tại
dvta: xoá all vị trí up map hiện tại
dcvt: bật tắt đánh chuyển vị trí
dck: bật tắt đánh chuyển khu
glv: bật tắt giữ level
ts: tàn sát
tsx: tàn sát theo id quái
tsn: tàn sát nhóm
pe hoặc e: tắt auto
npc: chuyển đến npc theo id
nm: next map
k: chuyển khu
fsk: fake skill theo id
rfsk: tắt fake skill
s: fake tốc độ chạy
g: di chuyển đến mục tiêu
ltd: lưu toạ độ
u: khinh công
d: độn thổ
r: dịch phải
l: dịch trái
gm: di chuyển đến map theo id
mnv: di chuyển đến map nhiệm vụ
mnvp: di chuyển đến map nv hằng ngày
hs: di chuyển đến Hirosaki
hr: di chuyển đến Haruna
oz: di chuyển đến Okaza
kj: di chuyển đến Kojin
sz: di chuyển đến Sanzu
tn: di chuyển đến Tone
lc: di chuyển đến Làng Chài
ck: di chuyển đến Chakumi
eg: di chuyển đến Echigo
os: di chuyển đến Oshin
bang - fz: băng boss và skill
bangb - fb: băng boss
bangs - fs: băng skill
pbang: phá băng boss và skill